10 10
1 1
10 10
1 1 1 1 1 1 4 7 8 x
1 1 1 1 1 1 1 5 8 8
1 1 1 1 1 1 1 4 6 7
1 1 1 1 1 x 1 1 3 6
1 1 1 1 1 x 1 1 1 1
1 1 1 1 1 1 1 1 1 1
6 1 1 1 1 x 1 1 1 1
7 7 1 x x x 1 1 1 1
8 8 1 1 1 1 1 1 1 1
x 8 7 1 1 1 1 1 1 1